+---+---+---+---+---+---+---+---+---+---+---+---+---+---+---+---+
|                                                               |
+   +---+---+---+---+---+---+---+---+---+---+---+---+---+---+   +
|   |                   |               |                       |
+   +   +---+   +---+   +---+---+---+   +   +---+   +   +   +   +
|   |   |       |                       |       |   |   |   |   |
+   +   +   +---+   +---+   +---+---+   +---+---+   +---+   +   +
|   |   |       |   |       |           |           |       |   |
+   +   +---+   +   +   +---+   +---+   +   +---+---+---+---+   +
|   |           |   |           |       |                   |   |
+   +   +   +---+---+---+---+   +   +---+---+---+   +---+   +   +
|   |   |                   |                   |       |   |   |
+   +   +---+---+---+---+   +---+   +---+---+   +---+   +   +   +
|   |   |               |       |                   |       |   |
+   +---+---+---+---+   +---+   +---+   +---+---+   +   +   +   +
|   |       |       |       |       |           |       |   |   |
+   +   +   +   +   +---+   +   +   +---+---+   +   +---+   +   +
|   |   |   |   |           |       |               |       |   |
+   +   +---+   +---+---+---+---+---+   +---+---+---+   +---+   +
|   |   |   |       |       |       |                   |   |   |
+   +   +   +   +   +   +   +   +   +---+   +---+   +---+   +   +
|   |       |   |   |   |       |   |   |   |       |       |   |
+   +   +   +   +   +   +   +---+   +   +   +   +---+   +   +   +
|   |   |   |   |   |   |   |       |   |   |       |   |   |   |
+   +   +   +   +   +   +   +   +---+   +   +---+   +   +   +   +
|   |   |   |   |   |   |   |           |       |       |   |   |
+   +   +   +   +   +   +   +   +---+---+---+   +   +   +   +   +
|               |   |   |   |   |               |   |   |   |   |
+   +   +---+---+---+---+---+   +   +---+---+---+---+   +   +   +
|   |                           |                               |
+   +   +---+---+---+---+---+---+---+---+---+---+---+---+---+   +
|   |                                                           |
+---+---+---+---+---+---+---+---+---+---+---+---+---+---+---+---+
