+---+---+---+---+---+---+---+---+---+---+---+---+---+---+---+---+
|                   |               |                           |
+   +---+---+---+   +   +---+---+   +   +---+---+---+---+---+   +
|           |       |   |           |   |       |           |   |
+   +---+   +   +---+   +   +---+---+   +   +   +   +---+   +   +
|   |       |   |                       |   |   |   |   |   |   |
+   +   +---+   +   +---+---+---+   +---+   +   +   +   +   +   +
|   |           |           |       |       |           |   |   |
+   +   +   +---+---+---+   +   +---+   +---+---+---+---+   +   +
|   |   |           |       |                   |           |   |
+   +   +---+---+   +   +---+   +---+---+---+   +   +---+   +   +
|   |           |   |       |           |       |       |   |   |
+   +---+---+   +   +   +   +---+---+   +   +---+   +   +   +   +
|       |       |       |               |           |   |   |   |
+   +   +   +---+   +---+---+---+   +   +---+   +---+   +   +   +
|   |   |   |       |       |       |       |   |       |       |
+   +   +   +   +---+   +   +   +   +---+   +   +   +---+---+   +
|   |   |   |   |       |   |       |       |   |           |   |
+   +   +   +   +   +---+   +---+---+   +---+   +---+---+   +   +
|   |   |   |   |       |           |       |           |   |   |
+   +   +   +   +---+   +---+   +   +---+   +---+   +   +   +   +
|   |   |   |   |           |   |       |       |   |   |   |   |
+   +   +   +   +   +---+   +   +   +   +---+   +   +   +   +   +
|   |   |   |   |       |   |   |   |       |       |   |   |   |
+   +   +   +   +---+   +   +   +---+---+   +   +---+   +   +   +
|   |   |   |           |   |       |       |   |       |   |   |
+   +   +   +---+---+---+   +---+   +   +---+   +   +   +   +   +
|   |   |   |               |       |               |   |   |   |
+   +   +   +   +---+---+---+   +---+---+---+---+---+   +   +   +
|       |   |                                               |   |
+---+   +   +---+   +---+---+---+---+---+---+---+---+---+---+   +
|                                                               |
+---+---+---+---+---+---+---+---+---+---+---+---+---+---+---+---+
