+---+---+---+---+---+
|   |   |   |   |   |
+---+   +   +   +   +
|           |       |
+---+   +   +---+   +
|       |       |   |
+---+   +   +---+   +
|       |       |   |
+   +   +   +   +   +
|   |   |   |       |
+---+---+---+---+---+
