+---+---+---+---+---+---+---+---+
|                               |
+   +   +   +   +   +   +   +   +
|                               |
+---+---+---+---+---+   +   +   +
|           |       |           |
+   +---+   +   +   +   +   +   +
|   |       |       |           |
+   +---+   +---+   +   +   +   +
|   |               |           |
+   +   +---+   +   +   +   +   +
|   |           |   |           |
+---+---+---+---+---+---+---+---+
